1 1    21 21
2 4    -4 21    -3 21    -2 21    -1 21
3 4    1 21    2 21    3 21    4 21
4 4    21 -4    21 -3    21 -2    21 -1
5 4    21 1    21 2    21 3    21 4
6 4    1 -1    2 -2    3 -3    4 -4
7 4    -4 4    -3 3    -2 2    -1 1
